##########################################
#........................................#
###.##.##.##.##.##.##.##.##.##.##.##.##.##
#........................................#
##.##.##.##.##.##.##.##.##.##.##.##.##.###
#........................................#
###.##.##.##.##.##.##.##.##.##.##.##.##.##
#........................................#
##.##.##.##.##.##.##.##.##.##.##.##.##.###
#........................................#
###.##.##.##.##.##.##.##.##.##.##.##.##.##
#........................................#
##.##.##.##.##.##.##.##.##.##.##.##.##.###
#........................................#
##########################################